#####r.#####
####.#e####r
##%#%%%.ep#r
##%#%#%.#...
##%%%#%.....
##p.#%%.....
r###%%#r###p
..##%###eX##
..r#%%%%.###
##..e###e###
#pe.####r###
##....######
