p#r#.p.##...
.#.#...##..r
.e.###.e....
#.###r#.####
#.##....e.r#
#.%#.##r#e##
#.%%%%##.%%%
#..r#%.#.%##
#####%#.%%e.
#..e.%%%%#..
#r.#.###e#.p
#..e.#p..###
